                                                                          #                                                                                                      
                                                                          #                                                                                                      
        +-----------+                  ###########                  +-----#-----+                                                                                                
        |...........|                  #         #                  |...........|                                                                                                
        |...........|                  ##       ##                  |...........|                                                                                                
        |...........|                   ###   ###                   |...........|                                                                                                
        |...........|                     ## ##                     |...........|                                                                                                
        |...........|                      ###                      |...........|                                                                                                
        |...........|                   +---#---+                   |....+------+                                                                                                
        |...........|                   |.......|                   |....|                                                                                                       
    +---+-------+...+-------------------+.......+-------------------+....+----------+                                                                                            
#####...............................................................................#####                                                                                        
    |...............................................................................|                                                                                            
    +---+-------+...+-------------------+.......+-------------------+...........+---+                                                                                            
        |...........|                   |.......|                   |...........|                                                                                                
        |...........|                   +---#---+                   |....+------+                                                                                                
        |...........|                       #                       |....|......|                                                                                                
        |...........|     +-------------+   #                       |....|......|                                                                                                
        |...........|     |.............####################        |....|......|                                                                                                
        |...........#######.............|                  #        |....|......|                                                                                                
        |...........|     |.............|                  #        |....|......|                                                                                                
        |...........#######.............|                  #        |....+--+...|                                                                                                
        |...........|     |.............|                  #        |...........####                                                                                             
        |...........|     +-----------#-+                  #        |...........|  #                                                                                             
        +-----------+                 #                    #        +-----------+  #                                                                                             
                                      #                    #                       #                                                                                             
                                      ##############################################                                                                                             
                                                                                                                                                                                 
